40 40
7 7 7 7 7 7 7 7 7 7 7 7 7 7 7 7 7 7 7 7 7 7 7 7 7 7 7 6 7 7 7 7 7 7 7 7 7 7 7 7
7 1 4 9 10 10 10 10 10 10 11 0 2 4 3 4 14 3 7 7 7 7 7 1 4 14 1 0 0 0 4 7 7 7 7 7 7 7 7 7
7 2 9 21 12 26 26 26 13 18 20 10 10 11 0 1 2 3 4 7 7 7 4 4 4 1 4 7 7 6 0 7 7 6 1 1 3 6 7 7
7 4 17 18 19 6 8 6 25 26 26 26 13 20 11 7 7 7 1 3 6 7 0 7 7 7 7 6 6 6 5 4 4 2 2 5 2 1 7 7
7 3 17 12 27 6 2 6 6 6 6 6 17 18 19 7 7 7 2 2 7 4 0 7 7 5 9 10 10 10 11 7 7 1 5 14 5 3 7 7
7 9 21 19 6 7 5 3 5 0 1 6 17 18 19 6 7 7 0 7 7 2 1 7 7 9 21 18 18 18 19 7 7 1 2 5 1 0 4 7
7 17 18 19 6 7 7 7 7 7 5 6 25 13 19 6 7 1 1 7 7 4 4 7 9 21 18 18 18 18 19 7 7 6 2 0 2 6 0 7
7 17 18 19 6 14 3 7 2 0 2 7 6 17 19 6 7 3 7 7 7 1 3 7 17 18 18 18 18 18 19 7 7 7 7 7 7 7 0 7
7 17 18 19 6 7 0 7 4 7 0 7 6 17 19 7 2 3 4 1 4 3 4 7 17 18 18 18 12 26 27 7 7 7 7 7 7 7 8 7
7 17 18 19 6 7 3 0 4 7 5 7 6 17 19 7 3 2 3 4 1 4 7 7 25 13 18 12 27 6 1 7 7 2 1 4 6 6 5 7
7 17 18 19 6 6 6 6 6 6 6 6 6 17 19 7 3 7 6 7 7 7 7 7 7 25 26 27 3 3 4 7 7 5 6 0 6 5 4 7
7 17 18 20 10 10 10 10 10 10 10 10 10 21 19 7 2 7 7 7 7 7 7 7 7 1 0 5 0 0 14 6 7 4 6 0 6 1 6 7
7 17 18 18 18 18 18 18 18 18 18 18 18 12 27 2 4 7 7 7 7 7 7 7 7 7 4 7 7 7 7 7 7 1 6 0 6 1 1 7
7 25 13 18 18 18 18 18 18 18 18 18 12 27 0 3 7 7 7 7 7 7 7 7 7 6 3 6 7 6 6 7 7 5 6 0 6 6 4 7
0 0 25 26 13 18 18 12 26 26 26 26 27 1 1 6 6 7 7 7 7 7 7 7 7 6 2 6 6 2 3 3 2 0 6 0 0 2 0 7
1 1 3 2 25 26 26 27 3 0 1 4 0 2 7 7 7 7 7 7 7 7 7 7 7 6 2 6 6 3 7 7 7 7 7 7 7 7 7 7
0 0 1 3 1 3 3 2 1 7 7 7 6 7 7 7 7 7 7 7 7 7 7 7 7 6 2 2 0 0 7 7 7 7 7 7 7 7 7 7
8 7 6 6 6 6 7 7 7 6 6 6 7 7 7 7 7 2 2 5 0 0 4 7 7 6 3 6 7 6 6 0 4 2 5 2 6 7 7 7
2 7 7 7 7 7 6 6 6 6 7 7 7 7 7 7 7 4 6 3 1 2 4 7 7 6 8 6 6 6 7 2 6 5 31 5 6 7 7 7
4 7 7 7 7 7 7 7 7 7 7 0 0 5 0 0 8 3 3 1 0 14 1 7 6 6 2 2 3 1 0 0 6 1 5 1 6 7 7 7
3 7 7 6 7 7 7 7 7 7 7 4 7 7 7 7 7 5 4 1 2 1 5 7 7 6 6 3 6 6 6 6 6 6 6 6 7 7 7 7
4 7 7 7 7 7 7 7 7 7 7 14 7 7 7 7 7 1 4 4 4 6 3 7 7 7 6 0 6 0 0 3 6 7 7 7 7 7 7 7
1 7 7 7 7 7 7 7 7 7 7 7 7 7 7 7 7 4 1 4 0 3 1 7 7 7 6 3 6 4 6 0 1 7 7 7 7 7 7 7
3 7 7 7 7 7 7 7 7 7 7 7 7 7 7 7 7 7 7 0 3 7 7 7 7 7 6 3 2 1 6 1 3 4 2 0 3 7 7 7
1 7 7 7 7 7 7 7 7 7 7 7 7 7 7 7 7 7 7 0 3 4 6 6 7 7 7 7 7 6 6 1 3 0 1 2 2 1 7 6
3 7 7 7 7 7 7 7 7 7 7 7 7 7 7 7 7 6 3 0 1 3 1 6 7 7 7 7 7 7 7 3 6 6 8 6 6 2 1 6
0 7 7 7 7 7 1 6 2 2 3 1 6 7 7 7 0 2 2 0 5 4 0 0 0 5 7 7 7 7 2 4 6 0 5 0 6 0 3 6
2 7 7 7 7 1 3 2 0 4 6 3 4 0 3 8 2 0 5 4 2 4 4 7 7 5 4 7 7 1 0 1 8 5 14 5 8 3 3 6
1 7 6 7 2 0 1 7 7 7 7 7 7 7 7 7 6 6 1 4 5 3 7 7 7 7 4 2 2 3 4 1 6 4 5 4 6 4 1 7
4 7 7 7 3 6 7 7 7 7 7 7 7 7 7 7 7 7 6 3 6 7 6 7 7 7 2 4 3 1 2 4 6 6 8 6 6 3 4 7
2 7 7 7 1 2 7 7 7 7 7 7 7 7 7 7 6 7 7 8 7 7 7 7 7 7 7 5 1 0 0 0 4 2 2 1 1 0 6 7
2 7 7 7 7 0 1 7 7 7 6 7 7 7 7 7 7 6 7 0 7 7 7 7 7 7 7 6 7 7 7 7 7 7 7 7 7 7 7 7
0 6 7 7 7 3 1 7 6 7 7 7 7 7 7 7 7 7 6 0 7 7 7 6 7 7 7 7 7 9 10 10 10 11 7 7 7 7 7 7
2 0 8 3 4 1 7 7 7 7 7 7 7 7 7 6 7 7 5 2 1 7 7 7 7 0 2 5 9 21 18 18 18 20 10 10 11 0 6 7
0 3 6 7 7 7 7 7 7 7 7 7 7 7 7 7 7 6 1 3 14 7 7 7 7 0 9 10 21 18 18 18 18 18 18 18 20 11 1 7
0 0 0 6 6 7 7 7 6 7 7 6 7 7 7 7 7 6 4 0 0 3 9 10 10 10 21 18 18 18 18 18 18 18 18 18 18 20 11 7
0 3 5 0 6 7 7 7 7 7 7 7 7 7 7 7 7 6 4 4 2 9 21 18 18 18 18 12 26 26 26 26 26 13 18 18 18 18 19 7
6 5 30 5 6 7 7 7 7 7 7 7 7 7 7 7 7 7 6 3 4 17 18 18 18 12 26 27 4 1 1 3 1 25 13 18 18 18 19 7
6 4 5 0 6 7 7 7 7 7 7 7 7 7 7 7 7 7 7 6 2 17 18 18 12 27 3 6 3 14 3 2 4 4 17 12 26 26 27 7
6 6 6 6 6 7 7 7 7 7 7 7 7 7 7 7 7 7 7 7 6 25 26 26 27 4 1 3 1 1 1 2 6 0 25 27 7 7 7 7